Afrikaans: Michael Bütow, peter hanox
Arabic: Ahmed A Khalil, Bassem Abdullah, Mohamed El-Kamony, Mosa AAA, Rudy Zeinoun, salem alajmi, shady abdo
Albanian: arianit
Armenian: Suren Karapetyan
Bulgarian: Boian Valentinov Todorov, Petra Milanova, Stoyan P. Bonkov
Catalan: Alex Guardiet
Chinese: Eric, Li Jiaxiang, Qiang Yuan, ricky, Tang Kai Yiu, xueyong, ZhouMo
Chinese (Taiwan): Abel Cheung, alex lee, cheng-han chiang, Cheng Ka Ho, Jamie, kourge, ming chang, something else, Tang Kai Yiu, Tony Tsang, Vincent M, wongpoyee
Croatian: Anto Anic, ZeroKillaz
Czech: Jiri Doubravsky, Martin Ambrož, Peter Stelcer, Vlastimil Skacel, Vlastislav Weiner
Danish: kenneth krabat, Malthe Sunesen
Dutch: alexanderpas, Carlo Martens, David Visser, Dennis Veenstra, eric, Frank Eising, Jan Schut, Koen Vits, manuel, Michel Pauwels, M.J.Louwe, noah, Patrick Catthoor, Paul Kassebaum, Petra van Assen, Tijmen, Wolf Hijlkema
Esperanto: Gabriel Beecham
Estonian: Aleksander Härmas, Priit Laes
Finnish: Aaro Juntunen, ett pok, Juha Heinänen, Matti Viljanen, Ni Mer, Tiia Kärkkäinen, Ville Virta
French: Ariel G, Christophe Riviere, David Maciejak, finder, Guilhem Bailly, Jürgen Köster, ludo, Ludovic Mirlatif, Nicolas, Raphael Chabert, sarah, Sébastien Mouren, Trollnumber1
German: Amun Abdulla, Bjoern Schlaak, Buschbeck, Carl-Marcus Pellmann, Gerald Schaftner, hein blöd, jan, leopold pichlmüller, marcel barion, Martin hoffman, Michael Krämer, Michael Tänzer, Milan Geh, Nando Filigrasso, oliver boht, Petra Wittkopf, Roman Gasser, romy ripperger, Ross Cohen, Sebastian Mosch, S. Hizo, Thomas Gruß, Thomas Magnet, Thomas Sandner, Wilhelm Hahn
Greek: Fotis and Chris, Leah Petra, Manouk Vartan Manoukian
Hebrew: Elhanan Ben-Yishay, eran raderman
Hungarian: Bíró Mariann, Javori Gabor, Kovács Rajmund, les Vorosmarthy, Peter Takacs, Tamas Szanto, tr, Vincze Márton
Irish: Gabriel Beecham
Italian: Alessandro Aglietti, ennio, franco, Giasone Argo, giuseppe marchetta, Hiram Oswaldo Pena Porras, Marco Solimando, massimo maccolini, matteo, max, max, Monty, motard, mp, napoli, serdean, stefano, TheBoss, valery, Vincenzo Reale
Japanese: Knagi, Megan E, Yasushi Iwata
Georgian: Aiet Kolkhi
Korean: Son, Kyeong-uk, Steve K Lee, Sung Jae, Cho
Lithuanian: Kestas Ermanas
Malay: Emirin Mohamed Kasah
Norwegian Bokmal: Audun Einangen, Knut Erik
Norwegian Nynorsk: tormod 
Polish: Adam Andrzejewski, Bartek Wisniewski, Citrus, Jozef Rozmus, Konrad Mantorski, Marek Adam, Markus Valen, olek lorenc, Piotr Drąg, Piotr Gospodarek, Szymon Adamczyk, Tomasz Kłosiński
Portuguese: wanteildo antunes ayres de lima, Tiago Filipe Gonçalves Afonso Sousa da Silva, Vandrei Cerqueira
Brazillian Portuguese: Brazukas são gays, Édipo Antunes, Gustavo Bruno, Natanael Pinho, Paulo Anselmo de Oliveira, Renan Valente Rangel, Renato, Vandrei Cerqueira, wanteildo antunes ayres de lima
Romanian: izabela, Lupoiu Victor Alexandru, Manea Costin, peter pann, Radu Ciuca
Russian: Andrey, Dmitry Bogatykh, Dmitry Bogatykh, Efremov, Pavel Maryanov, Pavel Vlasov, Shangin Alexander, Vladislav Zavyalov, Yuri
Slovak: Andrej Palička, fork27, jakub siska, jefko, savas
Slovenian: Dušan Mulac, Ervin, Jure Repinc, Jure Repinc
Spanish: alejandro ariel mac-kay, Ana Lago, bernardita errazuriz, Carlos Lozano, Christian Jaramillo, claudia, D4NNy, Damian Antonio Fenocchio, Daniel Gasco Rodriguez, elaine de lima, Francisco, Gustavo Attanasio, gustavo chianese, Jazmin Velazquez Lopez, juan Perez, juliana, Lucas Lux, monica, Néstor Peralta, Nicanor, Pablo Canale, pazuzu, rai
Spanish (Mexico): Cesar Armando Rodriguez, Daniel Gasco Rodriguez, Francisco, Hugo, Jose Guadalue Alvarez Cordoba, Jovani, juliana, Pablo Canale, zukaboy_gdl
Swedish: Christoffer Söderholm, David Vilhelmsson Ronad, Gabriela Soto Mora, Gustav Tiger, Henrik, Markus, Martin Svensson, mattias söderberg, Ross Cohen, Stefan, T. N., William Noritis
Thai: Supiti Buranawatanachoke
Turkish: Erhan Abay, Eryen AKGÜN, Levent, Oguzhan Yuzabasıoglu, Özcan Arslan, Ozgur Basar, Veysel Harun Sahin, z
Ukrainian Yakov Glumov
Vietnamese: Clytie Siddall
Welsh: Tony Sciubba
